0 0 1 1 -1 20 0 0 0
1 0 5 1 -1 20 0 0 0
2 0 1 1 -1 20 0 0 0
3 0 2 1 -1 20 0 0 0
4 0 1 1 -1 20 0 0 0
5 0 2 1 -1 20 0 0 0
6 0 2 0 -1 0 0 0 0
7 0 5 0 -1 0 0 0 0
8 0 2 0 -1 0 0 0 0
9 0 2 2 -1 0 80 0 0
10 0 5 2 -1 0 100 0 0
11 0 5 2 -1 0 100 0 0
12 0 5 2 -1 0 100 0 0
13 0 2 2 -1 0 80 0 0
14 0 5 2 -1 0 50 0 0
0 1 1 1 -1 50 0 0 0
1 1 5 1 -1 50 0 0 0
2 1 3 1 -1 50 0 0 0
3 1 1 1 -1 50 0 0 0
4 1 1 1 -1 50 0 0 0
5 1 5 1 -1 50 0 0 0
6 1 5 0 -1 0 0 0 0
7 1 5 0 -1 0 0 0 0
8 1 5 0 -1 0 0 0 0
9 1 1 2 -1 0 80 0 0
10 1 5 2 -1 0 100 0 0
11 1 0 2 1 0 100000000 0 0
12 1 5 2 -1 0 100 0 0
13 1 1 2 -1 0 80 0 0
14 1 2 2 -1 0 50 0 0
0 2 5 1 -1 50 0 0 0
1 2 2 1 -1 80 0 0 0
2 2 2 1 -1 80 0 0 0
3 2 5 1 -1 80 0 0 0
4 2 1 1 -1 80 0 0 0
5 2 1 1 -1 80 0 0 0
6 2 1 0 -1 0 0 0 0
7 2 5 0 -1 0 0 0 0
8 2 5 0 -1 0 0 0 0
9 2 1 2 -1 0 80 0 0
10 2 5 2 -1 0 100 0 0
11 2 5 2 -1 0 100 0 0
12 2 5 2 -1 0 100 0 0
13 2 1 2 -1 0 80 0 0
14 2 1 2 -1 0 50 0 0
0 3 5 1 -1 50 0 0 0
1 3 1 1 -1 80 0 0 0
2 3 5 1 -1 100 0 0 0
3 3 5 1 -1 100 0 0 0
4 3 5 1 -1 100 0 0 0
5 3 1 1 -1 80 0 0 0
6 3 1 0 -1 0 0 0 0
7 3 1 0 -1 0 0 0 0
8 3 2 0 -1 0 0 0 0
9 3 1 2 -1 0 80 0 0
10 3 1 2 -1 0 80 0 0
11 3 1 2 -1 0 80 0 0
12 3 1 2 -1 0 80 0 0
13 3 1 2 -1 0 80 0 0
14 3 1 2 -1 0 50 0 0
0 4 2 1 -1 50 0 0 0
1 4 5 1 -1 80 0 0 0
2 4 5 1 -1 100 0 0 0
3 4 0 1 0 100000000 0 0 0
4 4 5 1 -1 100 0 0 0
5 4 1 1 -1 80 0 0 0
6 4 1 0 -1 0 0 0 0
7 4 1 0 -1 0 0 0 0
8 4 1 0 -1 0 0 0 0
9 4 1 2 -1 0 50 0 0
10 4 1 2 -1 0 50 0 0
11 4 1 2 -1 0 50 0 0
12 4 1 2 -1 0 50 0 0
13 4 1 2 -1 0 50 0 0
14 4 1 2 -1 0 50 0 0
0 5 5 1 -1 50 0 0 0
1 5 5 1 -1 80 0 0 0
2 5 5 1 -1 100 0 0 0
3 5 5 1 -1 100 0 0 0
4 5 5 1 -1 100 0 0 0
5 5 1 1 -1 80 0 0 0
6 5 1 0 -1 0 0 0 0
7 5 1 0 -1 0 0 0 0
8 5 1 0 -1 0 0 0 0
9 5 1 2 -1 0 20 0 0
10 5 1 2 -1 0 20 0 0
11 5 5 2 -1 0 20 0 0
12 5 5 2 -1 0 20 0 0
13 5 5 2 -1 0 20 0 0
14 5 3 2 -1 0 20 0 0
0 6 5 0 -1 0 0 0 0
1 6 5 0 -1 0 0 0 0
2 6 6 0 -1 0 0 0 0
3 6 12 0 -1 0 0 0 0
4 6 1 0 -1 0 0 0 0
5 6 7 0 -1 0 0 0 0
6 6 12 0 -1 0 0 0 0
7 6 1 0 -1 0 0 0 0
8 6 1 0 -1 0 0 0 0
9 6 1 0 -1 0 0 0 0
10 6 1 0 -1 0 0 0 0
11 6 1 0 -1 0 0 0 0
12 6 5 0 -1 0 0 0 0
13 6 5 0 -1 0 0 0 0
14 6 4 0 -1 0 0 0 0
0 7 1 0 -1 0 0 0 0
1 7 1 0 -1 0 0 0 0
2 7 12 0 -1 0 0 0 0
3 7 12 0 -1 0 0 0 0
4 7 1 0 -1 0 0 0 0
5 7 12 0 -1 0 0 0 0
6 7 12 0 -1 0 0 0 0
7 7 8 0 -1 0 0 0 0
8 7 12 0 -1 0 0 0 0
9 7 12 0 -1 0 0 0 0
10 7 12 0 -1 0 0 0 0
11 7 1 0 -1 0 0 0 0
12 7 1 0 -1 0 0 0 0
13 7 1 0 -1 0 0 0 0
14 7 1 0 -1 0 0 0 0
0 8 1 0 -1 0 0 0 0
1 8 1 0 -1 0 0 0 0
2 8 1 0 -1 0 0 0 0
3 8 1 0 -1 0 0 0 0
4 8 1 0 -1 0 0 0 0
5 8 1 0 -1 0 0 0 0
6 8 1 0 -1 0 0 0 0
7 8 12 0 -1 0 0 0 0
8 8 12 0 -1 0 0 0 0
9 8 12 0 -1 0 0 0 0
10 8 12 0 -1 0 0 0 0
11 8 1 0 -1 0 0 0 0
12 8 1 0 -1 0 0 0 0
13 8 1 0 -1 0 0 0 0
14 8 5 0 -1 0 0 0 0
0 9 1 4 -1 10 0 0 20
1 9 1 4 -1 10 0 0 50
2 9 1 4 -1 10 0 0 50
3 9 1 4 -1 10 0 0 50
4 9 1 4 -1 10 0 0 50
5 9 1 4 -1 10 0 0 50
6 9 1 0 -1 0 0 0 0
7 9 12 0 -1 0 0 0 0
8 9 12 0 -1 0 0 0 0
9 9 2 3 -1 0 0 20 10
10 9 5 3 -1 0 0 20 0
11 9 1 3 -1 0 0 20 0
12 9 1 3 -1 0 0 20 0
13 9 1 3 -1 0 0 20 0
14 9 2 3 -1 0 0 20 0
0 10 2 4 -1 0 0 0 20
1 10 1 4 -1 0 0 0 50
2 10 1 4 -1 0 0 0 80
3 10 1 4 -1 0 0 0 80
4 10 1 4 -1 0 0 0 80
5 10 1 4 -1 0 0 0 80
6 10 1 0 -1 0 0 0 0
7 10 12 0 -1 0 0 0 0
8 10 12 0 -1 0 0 0 0
9 10 2 3 -1 0 0 20 10
10 10 1 3 -1 0 0 50 0
11 10 1 3 -1 0 0 50 0
12 10 1 3 -1 0 0 50 0
13 10 1 3 -1 0 0 50 0
14 10 1 3 -1 0 0 50 0
0 11 2 4 -1 0 0 0 20
1 11 1 4 -1 0 0 0 50
2 11 1 4 -1 0 0 0 80
3 11 5 4 -1 0 0 0 100
4 11 5 4 -1 0 0 0 100
5 11 5 4 -1 0 0 0 100
6 11 1 0 -1 0 0 0 0
7 11 1 0 -1 0 0 0 0
8 11 1 0 -1 0 0 0 0
9 11 1 3 -1 0 0 20 10
10 11 1 3 -1 0 0 50 0
11 11 1 3 -1 0 0 80 0
12 11 1 3 -1 0 0 80 0
13 11 5 3 -1 0 0 80 0
14 11 2 3 -1 0 0 80 0
0 12 5 4 -1 0 0 0 20
1 12 1 4 -1 0 0 0 50
2 12 1 4 -1 0 0 0 80
3 12 5 4 -1 0 0 0 100
4 12 0 4 3 0 0 0 100000000
5 12 5 4 -1 0 0 0 100
6 12 1 0 -1 0 0 0 0
7 12 1 0 -1 0 0 0 0
8 12 1 0 -1 0 0 0 0
9 12 1 3 -1 0 0 20 10
10 12 1 3 -1 0 0 50 0
11 12 1 3 -1 0 0 80 0
12 12 5 3 -1 0 0 100 0
13 12 5 3 -1 0 0 100 0
14 12 5 3 -1 0 0 100 0
0 13 3 4 -1 0 0 0 20
1 13 5 4 -1 0 0 0 50
2 13 1 4 -1 0 0 0 80
3 13 5 4 -1 0 0 0 100
4 13 5 4 -1 0 0 0 100
5 13 5 4 -1 0 0 0 100
6 13 1 0 -1 0 0 0 0
7 13 1 0 -1 0 0 0 0
8 13 1 0 -1 0 0 0 0
9 13 1 3 -1 0 0 20 10
10 13 5 3 -1 0 0 50 0
11 13 2 3 -1 0 0 80 0
12 13 5 3 -1 0 0 100 0
13 13 0 3 2 0 0 100000000 0
14 13 5 3 -1 0 0 100 0
0 14 2 4 -1 0 0 0 20
1 14 1 4 -1 0 0 0 50
2 14 2 4 -1 0 0 0 80
3 14 1 4 -1 0 0 0 80
4 14 1 4 -1 0 0 0 80
5 14 2 4 -1 0 0 0 80
6 14 2 0 -1 0 0 0 0
7 14 5 0 -1 0 0 0 0
8 14 4 0 -1 0 0 0 0
9 14 2 3 -1 0 0 20 10
10 14 2 3 -1 0 0 50 0
11 14 4 3 -1 0 0 80 0
12 14 5 3 -1 0 0 100 0
13 14 5 3 -1 0 0 100 0
14 14 5 3 -1 0 0 100 0
