0 0 5 1 -1 50 0 0 0
1 0 1 1 -1 50 0 0 0
2 0 1 1 -1 50 0 0 0
3 0 5 1 -1 50 0 0 0
4 0 1 1 -1 50 0 0 0
5 0 2 1 -1 20 0 0 0
6 0 2 0 -1 0 0 0 0
7 0 5 0 -1 0 0 0 0
8 0 1 0 -1 0 0 0 0
9 0 2 2 -1 0 20 0 0
10 0 1 2 -1 0 20 0 0
11 0 1 2 -1 0 20 0 0
12 0 2 2 -1 0 20 0 0
13 0 5 2 -1 0 20 0 0
14 0 5 2 -1 0 20 0 0
0 1 5 1 -1 80 0 0 0
1 1 5 1 -1 80 0 0 0
2 1 1 1 -1 80 0 0 0
3 1 1 1 -1 80 0 0 0
4 1 5 1 -1 50 0 0 0
5 1 2 1 -1 20 0 0 0
6 1 2 0 -1 0 0 0 0
7 1 2 0 -1 0 0 0 0
8 1 3 0 -1 0 0 0 0
9 1 3 2 -1 0 50 0 0
10 1 4 2 -1 0 50 0 0
11 1 1 2 -1 0 50 0 0
12 1 1 2 -1 0 50 0 0
13 1 1 2 -1 0 50 0 0
14 1 1 2 -1 0 50 0 0
0 2 5 1 -1 100 0 0 0
1 2 5 1 -1 100 0 0 0
2 2 5 1 -1 100 0 0 0
3 2 1 1 -1 80 0 0 0
4 2 1 1 -1 50 0 0 0
5 2 2 1 -1 20 0 0 0
6 2 3 0 -1 0 0 0 0
7 2 1 0 -1 0 0 0 0
8 2 1 0 -1 0 0 0 0
9 2 4 2 -1 0 50 0 0
10 2 4 2 -1 0 80 0 0
11 2 1 2 -1 0 80 0 0
12 2 1 2 -1 0 80 0 0
13 2 1 2 -1 0 80 0 0
14 2 1 2 -1 0 80 0 0
0 3 5 1 -1 100 0 0 0
1 3 0 1 0 100000000 0 0 0
2 3 5 1 -1 100 0 0 0
3 3 1 1 -1 80 0 0 0
4 3 1 1 -1 50 0 0 0
5 3 1 1 -1 20 0 0 0
6 3 6 0 -1 0 0 0 0
7 3 12 0 -1 0 0 0 0
8 3 1 0 -1 0 0 0 0
9 3 5 2 -1 0 50 0 0
10 3 5 2 -1 0 80 0 0
11 3 5 2 -1 0 100 0 0
12 3 5 2 -1 0 100 0 0
13 3 5 2 -1 0 100 0 0
14 3 5 2 -1 0 80 0 0
0 4 5 1 -1 100 0 0 0
1 4 5 1 -1 100 0 0 0
2 4 5 1 -1 100 0 0 0
3 4 1 1 -1 80 0 0 0
4 4 1 1 -1 50 0 0 0
5 4 1 1 -1 20 0 0 0
6 4 12 0 -1 0 0 0 0
7 4 12 0 -1 0 0 0 0
8 4 1 0 -1 0 0 0 0
9 4 1 2 -1 0 50 0 0
10 4 5 2 -1 0 80 0 0
11 4 5 2 -1 0 100 0 0
12 4 0 2 1 0 100000000 0 0
13 4 5 2 -1 0 100 0 0
14 4 1 2 -1 0 80 0 0
0 5 3 1 -1 80 0 0 0
1 5 1 1 -1 80 0 0 0
2 5 1 1 -1 80 0 0 0
3 5 1 1 -1 80 0 0 0
4 5 2 1 -1 50 0 0 0
5 5 5 1 -1 20 0 0 0
6 5 1 0 -1 0 0 0 0
7 5 5 0 -1 0 0 0 0
8 5 5 0 -1 0 0 0 0
9 5 1 2 -1 0 50 0 0
10 5 1 2 -1 0 80 0 0
11 5 5 2 -1 0 100 0 0
12 5 5 2 -1 0 100 0 0
13 5 5 2 -1 0 100 0 0
14 5 1 2 -1 0 80 0 0
0 6 1 0 -1 0 0 0 0
1 6 1 0 -1 0 0 0 0
2 6 1 0 -1 0 0 0 0
3 6 5 0 -1 0 0 0 0
4 6 2 0 -1 0 0 0 0
5 6 3 0 -1 0 0 0 0
6 6 5 0 -1 0 0 0 0
7 6 5 0 -1 0 0 0 0
8 6 5 0 -1 0 0 0 0
9 6 2 0 -1 0 0 0 0
10 6 5 0 -1 0 0 0 0
11 6 1 0 -1 0 0 0 0
12 6 2 0 -1 0 0 0 0
13 6 2 0 -1 0 0 0 0
14 6 4 0 -1 0 0 0 0
0 7 2 0 -1 0 0 0 0
1 7 1 0 -1 0 0 0 0
2 7 1 0 -1 0 0 0 0
3 7 2 0 -1 0 0 0 0
4 7 5 0 -1 0 0 0 0
5 7 5 0 -1 0 0 0 0
6 7 5 0 -1 0 0 0 0
7 7 8 0 -1 0 0 0 0
8 7 12 0 -1 0 0 0 0
9 7 12 0 -1 0 0 0 0
10 7 12 0 -1 0 0 0 0
11 7 4 0 -1 0 0 0 0
12 7 1 0 -1 0 0 0 0
13 7 5 0 -1 0 0 0 0
14 7 3 0 -1 0 0 0 0
0 8 5 0 -1 0 0 0 0
1 8 5 0 -1 0 0 0 0
2 8 4 0 -1 0 0 0 0
3 8 5 0 -1 0 0 0 0
4 8 1 0 -1 0 0 0 0
5 8 2 0 -1 0 0 0 0
6 8 5 0 -1 0 0 0 0
7 8 12 0 -1 0 0 0 0
8 8 12 0 -1 0 0 0 0
9 8 12 0 -1 0 0 0 0
10 8 12 0 -1 0 0 0 0
11 8 5 0 -1 0 0 0 0
12 8 4 0 -1 0 0 0 0
13 8 1 0 -1 0 0 0 0
14 8 1 0 -1 0 0 0 0
0 9 2 4 -1 0 0 0 20
1 9 5 4 -1 0 0 0 20
2 9 2 4 -1 0 0 0 20
3 9 3 4 -1 0 0 0 20
4 9 2 4 -1 0 0 0 20
5 9 3 4 -1 0 0 0 20
6 9 5 0 -1 0 0 0 0
7 9 12 0 -1 0 0 0 0
8 9 12 0 -1 0 0 0 0
9 9 1 3 -1 0 10 80 0
10 9 1 3 -1 0 10 80 0
11 9 5 3 -1 0 10 80 0
12 9 5 3 -1 0 10 80 0
13 9 2 3 -1 0 10 80 0
14 9 3 3 -1 0 10 50 0
0 10 4 4 -1 0 0 0 50
1 10 2 4 -1 0 0 0 50
2 10 1 4 -1 0 0 0 50
3 10 5 4 -1 0 0 0 50
4 10 5 4 -1 0 0 0 50
5 10 5 4 -1 0 0 0 20
6 10 3 0 -1 0 0 0 0
7 10 12 0 -1 0 0 0 0
8 10 12 0 -1 0 0 0 0
9 10 1 3 -1 0 0 80 0
10 10 5 3 -1 0 0 100 0
11 10 5 3 -1 0 0 100 0
12 10 5 3 -1 0 0 100 0
13 10 5 3 -1 0 0 80 0
14 10 2 3 -1 0 0 50 0
0 11 1 4 -1 0 0 0 80
1 11 5 4 -1 0 0 0 80
2 11 1 4 -1 0 0 0 80
3 11 5 4 -1 0 0 0 80
4 11 5 4 -1 0 0 0 50
5 11 5 4 -1 0 0 0 20
6 11 3 0 -1 0 0 0 0
7 11 2 0 -1 0 0 0 0
8 11 1 0 -1 0 0 0 0
9 11 1 3 -1 0 0 80 0
10 11 5 3 -1 0 0 100 0
11 11 0 3 2 0 0 100000000 0
12 11 5 3 -1 0 0 100 0
13 11 1 3 -1 0 0 80 0
14 11 1 3 -1 0 0 50 0
0 12 5 4 -1 0 0 0 100
1 12 5 4 -1 0 0 0 100
2 12 5 4 -1 0 0 0 100
3 12 1 4 -1 0 0 0 80
4 12 3 4 -1 0 0 0 50
5 12 1 4 -1 0 0 0 20
6 12 2 0 -1 0 0 0 0
7 12 1 0 -1 0 0 0 0
8 12 1 0 -1 0 0 0 0
9 12 1 3 -1 0 0 80 0
10 12 5 3 -1 0 0 100 0
11 12 5 3 -1 0 0 100 0
12 12 5 3 -1 0 0 100 0
13 12 4 3 -1 0 0 80 0
14 12 5 3 -1 0 0 50 0
0 13 5 4 -1 0 0 0 100
1 13 0 4 3 0 0 0 100000000
2 13 5 4 -1 0 0 0 100
3 13 3 4 -1 0 0 0 80
4 13 5 4 -1 0 0 0 50
5 13 2 4 -1 0 0 0 20
6 13 7 0 -1 0 0 0 0
7 13 12 0 -1 0 0 0 0
8 13 1 0 -1 0 0 0 0
9 13 1 3 -1 0 0 80 0
10 13 3 3 -1 0 0 80 0
11 13 2 3 -1 0 0 80 0
12 13 3 3 -1 0 0 80 0
13 13 5 3 -1 0 0 80 0
14 13 5 3 -1 0 0 50 0
0 14 5 4 -1 0 0 0 100
1 14 5 4 -1 0 0 0 100
2 14 5 4 -1 0 0 0 100
3 14 3 4 -1 0 0 0 80
4 14 4 4 -1 0 0 0 50
5 14 5 4 -1 0 0 0 20
6 14 12 0 -1 0 0 0 0
7 14 12 0 -1 0 0 0 0
8 14 2 0 -1 0 0 0 0
9 14 1 3 -1 0 0 50 0
10 14 5 3 -1 0 0 50 0
11 14 2 3 -1 0 0 50 0
12 14 5 3 -1 0 0 50 0
13 14 2 3 -1 0 0 50 0
14 14 5 3 -1 0 0 50 0
